1000000001
0110010110
0100100010
0001101000
0100001100
0011000010
0001011000
0100010010
0110100112
1000000001